% init
0,0 2,_,_,D

% find loc
2,0 _,_,_,R
2,1 3,_,R,_
0,1 1,_,R,_

% back
1,1 _,_,L,R
1,0 _,_,L,R

% finish
3,0 4,_,_,D
4,0 _,1,_,_
4,1 _,_,_,_
