% B -> e
0,0 2,_,_,D
2,0 _,_,_,R

% A -> e
2,1 3,_,_,D
3,0 _,3,R,_
0,3 3,_,_,R

% end
1,3 _,_,_,R
1,0 _,1,_,_
1,1 _,_,_,_
