% init
0,0 2,_,L,_
0,2 3,_,_,R
3,0 _,3,_,L
3,2 4,_,_,_

% first corner
4,2 _,_,_,D
4,0 _,_,R,R

% pulldown
2,0 _,2,_,U
2,3 _,2,_,_
2,2 _,_,_,L
2,4 _,_,R,_
0,4 3,_,_,_
