% init
0,0 2,3,_,_
2,2 _,_,D,U
2,3 _,_,R,_
0,3 2,_,_,R
2,0 3,2,U,_

% runup
%3,2 _,_,U,_
0,2 1,_,U,_
1,0 2,_,D,_
3,0 _,_,D,_

% end
2,1 3,2,_,L
3,3 _,_,_,_
1,2 2,3,U,R
3,2 _,_,_,_
1,3 2,_,L,R
