% init
0,0 4,_,D,_
0,4 2,_,D,_
1,4 _,_,_,D
1,2 _,_,_,D

% roll to end
1,1 4,_,U,U
2,2 _,_,_,R
2,0 _,_,_,R
2,1 3,_,D,D
3,1 _,_,D,D

% pull back
4,0 _,1,_,L
4,4 _,_,U,U
3,3 _,_,U,_
2,3 _,_,_,U
3,0 _,_,D,D
4,1 _,_,_,L

% end
4,3 _,_,_,_
