% pyr
0,0 4,_,_,D
4,0 _,2,D,_
0,2 4,_,D,_
2,2 3,_,U,_
4,3 _,_,U,_
0,3 _,_,R,R

% end
1,2 2,3,_,_
2,3 _,_,_,_
0,1 3,2,_,_
3,2 _,_,_,_
1,0 2,3,_,_
