% init
0,0 2,_,_,D

% B -> e
2,0 _,4,U,_
0,4 3,_,_,R
3,0 _,2,U,_
0,2 3,_,_,R

% A -> s
3,1 _,_,D,_

% A -> e
2,1 _,_,R,_
0,1 _,_,R,_

% B -> s
1,1 _,_,_,L
1,2 4,3,U,_
0,3 4,_,_,L
4,2 _,3,U,_

% elt
1,4 4,_,_,_

% rect
4,4 _,_,_,D
4,0 5,5,L,_
0,5 1,_,_,R
1,0 _,5,L,_
3,5 _,_,R,_
1,5 _,_,R,_
5,5 _,_,D,_
4,5 _,_,_,R

% end
2,5 5,_,_,R
5,0 _,1,_,_
5,1 _,_,_,_
