% init
0,0 2,1,D,_

% row
0,2 2,_,_,R
% zstep
2,0 3,1,R,_
0,1 2,_,_,R
2,1 3,_,R,_
1,1 _,_,L,L
3,1 _,_,L,L
% next
3,2 _,_,D,_

% end
1,2 3,_,U,D
3,3 _,_,U,D
2,3 _,_,R,_
1,3 _,_,R,R
1,0 _,_,R,R
