% init
0,0 2,_,D,_
0,2 3,_,D,_
1,2 _,_,U,_
3,2 _,_,U,_

% find row
2,2 _,_,_,D
2,6 _,_,_,D

% zstep row
2,3 _,_,R,_
0,3 3,6,_,R
3,3 _,6,_,R
3,0 _,4,R,_
0,4 3,5,_,R
3,4 _,5,_,R

% counter
3,1 _,_,U,_
0,1 3,5,_,_

% shift to start
3,5 _,_,L,L
0,5 _,_,L,L
0,6 4,_,D,_
4,6 _,_,D,_

% reorient
2,1 _,7,U,_
4,7 5,_,U,_
0,7 _,_,D,_

% zstep to mode
5,7 _,8,_,_
5,8 _,_,R,_
0,8 5,_,_,R
5,0 _,8,R,_

% end
3,8 4,_,_,R
4,0 _,1,_,_
4,1 _,_,_,_
