% init
0,0 3,_,_,_

% row loop
3,3 _,_,D,_
0,3 2,_,_,R
% zstep
2,0 3,2,R,_
2,2 3,_,R,_
0,2 2,_,_,R
1,0 3,2,R,_
1,2 _,_,L,L
3,2 _,_,L,L

% end
1,3 2,_,_,R
