% loop
0,0 1,_,_,D
1,0 2,_,_,D
2,0 3,_,_,D
3,0 _,_,_,U
3,3 _,_,R,R

% end
1,1 2,2,_,_
2,1 2,2,_,_
3,1 3,2,_,_
2,2 _,_,_,_
3,2 _,_,_,_
