% 8 move states
0,0 1,_,_,R
1,0 2,_,_,D
2,0 3,_,_,D
3,0 4,_,_,D
4,0 5,_,_,R
5,0 6,_,_,U
6,0 7,_,_,U
7,0 _,_,L,U
% locate states
0,1 _,2,_,_
1,1 _,2,_,_
2,1 _,2,_,_
3,1 _,2,_,_
4,1 _,2,_,_
5,1 _,2,_,_
6,1 _,2,_,_
7,1 _,2,_,_
% halt states
0,2 _,_,_,_
1,2 _,_,_,_
2,2 _,_,_,_
3,2 _,_,_,_
4,2 _,_,_,_
5,2 _,_,_,_
6,2 _,_,_,_
7,2 _,_,_,_
