% spiral
5,0 _,2,_,U
5,2 _,_,_,R
5,3 _,_,D,R
2,0 _,3,_,L
2,3 _,_,_,U
2,4 3,_,_,U
3,0 _,4,_,D
3,4 _,_,_,L
3,5 4,_,_,L
4,0 _,5,_,R
4,5 _,_,_,D
4,2 5,_,_,D

% carryover
4,4 _,_,_,D

% full init
0,0 1,_,D,_
0,1 2,_,U,_
1,1 2,5,R,_
0,2 3,_,L,_
2,2 3,_,U,_
0,3 4,_,D,_
3,3 4,_,L,_
0,4 5,_,R,_

% end
2,1 3,2,_,_
3,1 _,2,_,_
4,1 _,_,R,_
5,1 _,_,R,_
3,2 _,_,_,_

% edge
1,2 2,5,_,_
1,3 2,5,_,_
1,4 2,5,_,_
0,5 _,_,_,_
2,5 _,_,_,_
