% init
0,0 2,1,D,_

% row
0,2 2,_,_,L
% zstep
2,0 3,1,R,_
0,1 2,_,_,L
2,1 3,_,R,_
1,1 _,_,L,R
3,1 _,_,L,R
% next
3,2 _,_,D,_

% end
1,2 2,_,U,D
3,3 _,_,U,D

% expr
2,2 _,3,L,_
1,3 _,_,_,R
1,0 _,1,_,_

% halt??
2,3 _,_,_,_
