% init
0,0 1,_,_,D
1,0 4,2,D,D
2,0 _,_,U,D

% loop
4,0 _,2,R,_
0,2 3,_,_,U
3,0 _,3,_,U
3,2 _,3,_,U
3,4 4,_,_,D
4,3 _,_,_,D
4,2 _,_,_,R

% end
3,1 4,2,D,U
1,2 2,_,_,_
2,2 _,_,_,_
0,4 _,_,_,_
4,1 _,2,D,U
